"filename", "language", "MATLAB", "Properties", "Markdown", "Plain Text (PDF)", "comment", "blank", "total"
"c:\Users\mirac\OneDrive\桌面\GraduationProject\Code-Ibrahim\MSNs-system\.gitattributes", "Properties", 0, 1, 0, 0, 1, 1, 3
"c:\Users\mirac\OneDrive\桌面\GraduationProject\Code-Ibrahim\MSNs-system\Animate.m", "MATLAB", 0, 0, 0, 0, 1, 0, 1
"c:\Users\mirac\OneDrive\桌面\GraduationProject\Code-Ibrahim\MSNs-system\MN_INIT.m", "MATLAB", 55, 0, 0, 0, 14, 17, 86
"c:\Users\mirac\OneDrive\桌面\GraduationProject\Code-Ibrahim\MSNs-system\MSN_AREA.m", "MATLAB", 14, 0, 0, 0, 9, 5, 28
"c:\Users\mirac\OneDrive\桌面\GraduationProject\Code-Ibrahim\MSNs-system\MSN_CALCULATE2.m", "MATLAB", 117, 0, 0, 0, 59, 18, 194
"c:\Users\mirac\OneDrive\桌面\GraduationProject\Code-Ibrahim\MSNs-system\MSN_CALCULATE_ave.m", "MATLAB", 71, 0, 0, 0, 41, 14, 126
"c:\Users\mirac\OneDrive\桌面\GraduationProject\Code-Ibrahim\MSNs-system\MSN_CALCULATE_oneday.m", "MATLAB", 102, 0, 0, 0, 59, 20, 181
"c:\Users\mirac\OneDrive\桌面\GraduationProject\Code-Ibrahim\MSNs-system\MSN_INIT.m", "MATLAB", 38, 0, 0, 0, 16, 13, 67
"c:\Users\mirac\OneDrive\桌面\GraduationProject\Code-Ibrahim\MSNs-system\MSN_ROUTING.m", "MATLAB", 114, 0, 0, 0, 48, 33, 195
"c:\Users\mirac\OneDrive\桌面\GraduationProject\Code-Ibrahim\MSNs-system\MSN_RPM2.m", "MATLAB", 349, 0, 0, 0, 148, 82, 579
"c:\Users\mirac\OneDrive\桌面\GraduationProject\Code-Ibrahim\MSNs-system\MSN_RPM3.m", "MATLAB", 338, 0, 0, 0, 111, 66, 515
"c:\Users\mirac\OneDrive\桌面\GraduationProject\Code-Ibrahim\MSNs-system\MSN_system.m", "MATLAB", 27, 0, 0, 0, 26, 12, 65
"c:\Users\mirac\OneDrive\桌面\GraduationProject\Code-Ibrahim\MSNs-system\MSN_system2.m", "MATLAB", 6, 0, 0, 0, 17, 9, 32
"c:\Users\mirac\OneDrive\桌面\GraduationProject\Code-Ibrahim\MSNs-system\Plot_Area.m", "MATLAB", 14, 0, 0, 0, 6, 3, 23
"c:\Users\mirac\OneDrive\桌面\GraduationProject\Code-Ibrahim\MSNs-system\Plot_MNtrace.m", "MATLAB", 0, 0, 0, 0, 3, 0, 3
"c:\Users\mirac\OneDrive\桌面\GraduationProject\Code-Ibrahim\MSNs-system\README.md", "Markdown", 0, 0, 1, 0, 0, 1, 2
"c:\Users\mirac\OneDrive\桌面\GraduationProject\Code-Ibrahim\MSNs-system\RPM.pdf", "Plain Text (PDF)", 0, 0, 0, 309, 0, 2, 311
"c:\Users\mirac\OneDrive\桌面\GraduationProject\Code-Ibrahim\MSNs-system\SCPR.m", "MATLAB", 68, 0, 0, 0, 44, 30, 142
"c:\Users\mirac\OneDrive\桌面\GraduationProject\Code-Ibrahim\MSNs-system\TIME_DISPLAY.m", "MATLAB", 0, 0, 0, 0, 3, 2, 5
"c:\Users\mirac\OneDrive\桌面\GraduationProject\Code-Ibrahim\MSNs-system\create_new_message.m", "MATLAB", 19, 0, 0, 0, 14, 9, 42
"c:\Users\mirac\OneDrive\桌面\GraduationProject\Code-Ibrahim\MSNs-system\get_metric_value.m", "MATLAB", 12, 0, 0, 0, 8, 6, 26
"c:\Users\mirac\OneDrive\桌面\GraduationProject\Code-Ibrahim\MSNs-system\get_reception_duration.m", "MATLAB", 9, 0, 0, 0, 10, 5, 24
"c:\Users\mirac\OneDrive\桌面\GraduationProject\Code-Ibrahim\MSNs-system\refresh_buffers.m", "MATLAB", 16, 0, 0, 0, 8, 6, 30
"c:\Users\mirac\OneDrive\桌面\GraduationProject\Code-Ibrahim\MSNs-system\setForward.m", "MATLAB", 34, 0, 0, 0, 16, 37, 87
"c:\Users\mirac\OneDrive\桌面\GraduationProject\Code-Ibrahim\MSNs-system\test.m", "MATLAB", 0, 0, 0, 0, 0, 1, 1
"c:\Users\mirac\OneDrive\桌面\GraduationProject\Code-Ibrahim\MSNs-system\移动社会网络中基于社会活跃度的路由策略研究.md", "Markdown", 0, 0, 18, 0, 0, 13, 31
"c:\Users\mirac\OneDrive\桌面\GraduationProject\Code-Ibrahim\MSNs-system\移动社会网络中基于社会活跃度的路由策略研究.pdf", "Plain Text (PDF)", 0, 0, 0, 2158, 0, 5, 2163
"c:\Users\mirac\OneDrive\桌面\GraduationProject\Code-Ibrahim\MSNs-system\调试代码\MSN_CALCULATE2.m", "MATLAB", 0, 0, 0, 0, 0, 1, 1
"c:\Users\mirac\OneDrive\桌面\GraduationProject\Code-Ibrahim\MSNs-system\调试代码\MSN_RPM1.m", "MATLAB", 254, 0, 0, 0, 145, 74, 473
"c:\Users\mirac\OneDrive\桌面\GraduationProject\Code-Ibrahim\MSNs-system\调试代码\MSN_RPM1_test.m", "MATLAB", 254, 0, 0, 0, 145, 74, 473
"c:\Users\mirac\OneDrive\桌面\GraduationProject\Code-Ibrahim\MSNs-system\调试代码\MSN_RPM3.m", "MATLAB", 276, 0, 0, 0, 162, 71, 509
"Total", "-", 2187, 1, 19, 2467, 1114, 630, 6418