"filename", "language", "Properties", "MATLAB", "Markdown", "Plain Text (PDF)", "comment", "blank", "total"
"c:\Users\mirac\OneDrive\桌面\GraduationProject\Code-Ibrahim\MSNs-system\.gitattributes", "Properties", 1, 0, 0, 0, 1, 1, 3
"c:\Users\mirac\OneDrive\桌面\GraduationProject\Code-Ibrahim\MSNs-system\Animate.m", "MATLAB", 0, 0, 0, 0, 1, 0, 1
"c:\Users\mirac\OneDrive\桌面\GraduationProject\Code-Ibrahim\MSNs-system\MN_INIT.m", "MATLAB", 0, 57, 0, 0, 11, 16, 84
"c:\Users\mirac\OneDrive\桌面\GraduationProject\Code-Ibrahim\MSNs-system\MSN_AREA.m", "MATLAB", 0, 12, 0, 0, 9, 5, 26
"c:\Users\mirac\OneDrive\桌面\GraduationProject\Code-Ibrahim\MSNs-system\MSN_CALCULATE2.m", "MATLAB", 0, 225, 0, 0, 72, 24, 321
"c:\Users\mirac\OneDrive\桌面\GraduationProject\Code-Ibrahim\MSNs-system\MSN_CALCULATE3.m", "MATLAB", 0, 181, 0, 0, 64, 22, 267
"c:\Users\mirac\OneDrive\桌面\GraduationProject\Code-Ibrahim\MSNs-system\MSN_INIT.m", "MATLAB", 0, 40, 0, 0, 16, 13, 69
"c:\Users\mirac\OneDrive\桌面\GraduationProject\Code-Ibrahim\MSNs-system\MSN_ROUTING.m", "MATLAB", 0, 128, 0, 0, 48, 30, 206
"c:\Users\mirac\OneDrive\桌面\GraduationProject\Code-Ibrahim\MSNs-system\MSN_RPM3.m", "MATLAB", 0, 342, 0, 0, 114, 68, 524
"c:\Users\mirac\OneDrive\桌面\GraduationProject\Code-Ibrahim\MSNs-system\MSN_system_epidemic.m", "MATLAB", 0, 7, 0, 0, 17, 8, 32
"c:\Users\mirac\OneDrive\桌面\GraduationProject\Code-Ibrahim\MSNs-system\MSN_system_null.m", "MATLAB", 0, 6, 0, 0, 18, 9, 33
"c:\Users\mirac\OneDrive\桌面\GraduationProject\Code-Ibrahim\MSNs-system\MSN_system_prophet.m", "MATLAB", 0, 7, 0, 0, 17, 8, 32
"c:\Users\mirac\OneDrive\桌面\GraduationProject\Code-Ibrahim\MSNs-system\MSN_system_scpr.m", "MATLAB", 0, 7, 0, 0, 17, 8, 32
"c:\Users\mirac\OneDrive\桌面\GraduationProject\Code-Ibrahim\MSNs-system\MSN_system_simbet.m", "MATLAB", 0, 7, 0, 0, 17, 8, 32
"c:\Users\mirac\OneDrive\桌面\GraduationProject\Code-Ibrahim\MSNs-system\Plot_Area.m", "MATLAB", 0, 14, 0, 0, 6, 3, 23
"c:\Users\mirac\OneDrive\桌面\GraduationProject\Code-Ibrahim\MSNs-system\Plot_MNtrace.m", "MATLAB", 0, 0, 0, 0, 3, 0, 3
"c:\Users\mirac\OneDrive\桌面\GraduationProject\Code-Ibrahim\MSNs-system\README.md", "Markdown", 0, 0, 1, 0, 0, 1, 2
"c:\Users\mirac\OneDrive\桌面\GraduationProject\Code-Ibrahim\MSNs-system\RPM.pdf", "Plain Text (PDF)", 0, 0, 0, 309, 0, 2, 311
"c:\Users\mirac\OneDrive\桌面\GraduationProject\Code-Ibrahim\MSNs-system\in_Refresh_ID.m", "MATLAB", 0, 36, 0, 0, 5, 10, 51
"c:\Users\mirac\OneDrive\桌面\GraduationProject\Code-Ibrahim\MSNs-system\in_already_received_cleared.m", "MATLAB", 0, 52, 0, 0, 10, 41, 103
"c:\Users\mirac\OneDrive\桌面\GraduationProject\Code-Ibrahim\MSNs-system\in_create_new_message.m", "MATLAB", 0, 19, 0, 0, 14, 9, 42
"c:\Users\mirac\OneDrive\桌面\GraduationProject\Code-Ibrahim\MSNs-system\in_get_metric_value.m", "MATLAB", 0, 12, 0, 0, 8, 6, 26
"c:\Users\mirac\OneDrive\桌面\GraduationProject\Code-Ibrahim\MSNs-system\in_get_reception_duration.m", "MATLAB", 0, 9, 0, 0, 10, 5, 24
"c:\Users\mirac\OneDrive\桌面\GraduationProject\Code-Ibrahim\MSNs-system\in_refresh_buffers.m", "MATLAB", 0, 16, 0, 0, 8, 5, 29
"c:\Users\mirac\OneDrive\桌面\GraduationProject\Code-Ibrahim\MSNs-system\protocol_Epidemic.m", "MATLAB", 0, 0, 0, 0, 0, 1, 1
"c:\Users\mirac\OneDrive\桌面\GraduationProject\Code-Ibrahim\MSNs-system\protocol_NULL.m", "MATLAB", 0, 49, 0, 0, 32, 21, 102
"c:\Users\mirac\OneDrive\桌面\GraduationProject\Code-Ibrahim\MSNs-system\protocol_Prophet.m", "MATLAB", 0, 0, 0, 0, 0, 1, 1
"c:\Users\mirac\OneDrive\桌面\GraduationProject\Code-Ibrahim\MSNs-system\protocol_SCPR.m", "MATLAB", 0, 129, 0, 0, 55, 42, 226
"c:\Users\mirac\OneDrive\桌面\GraduationProject\Code-Ibrahim\MSNs-system\protocol_SCPRsetForward.m", "MATLAB", 0, 16, 0, 0, 9, 11, 36
"c:\Users\mirac\OneDrive\桌面\GraduationProject\Code-Ibrahim\MSNs-system\protocol_SimBet.m", "MATLAB", 0, 0, 0, 0, 0, 1, 1
"c:\Users\mirac\OneDrive\桌面\GraduationProject\Code-Ibrahim\MSNs-system\protocol_SimBetUtil_calc.m", "MATLAB", 0, 32, 0, 0, 12, 24, 68
"c:\Users\mirac\OneDrive\桌面\GraduationProject\Code-Ibrahim\MSNs-system\protocol_SimBet_forward.m", "MATLAB", 0, 17, 0, 0, 0, 10, 27
"c:\Users\mirac\OneDrive\桌面\GraduationProject\Code-Ibrahim\MSNs-system\移动社会网络中基于社会活跃度的路由策略研究.md", "Markdown", 0, 0, 18, 0, 0, 13, 31
"c:\Users\mirac\OneDrive\桌面\GraduationProject\Code-Ibrahim\MSNs-system\移动社会网络中基于社会活跃度的路由策略研究.pdf", "Plain Text (PDF)", 0, 0, 0, 2158, 0, 5, 2163
"c:\Users\mirac\OneDrive\桌面\GraduationProject\Code-Ibrahim\MSNs-system\调试代码\MSN_CALCULATE2.m", "MATLAB", 0, 0, 0, 0, 0, 1, 1
"c:\Users\mirac\OneDrive\桌面\GraduationProject\Code-Ibrahim\MSNs-system\调试代码\MSN_RPM1.m", "MATLAB", 0, 254, 0, 0, 145, 74, 473
"c:\Users\mirac\OneDrive\桌面\GraduationProject\Code-Ibrahim\MSNs-system\调试代码\MSN_RPM1_test.m", "MATLAB", 0, 254, 0, 0, 145, 74, 473
"c:\Users\mirac\OneDrive\桌面\GraduationProject\Code-Ibrahim\MSNs-system\调试代码\MSN_RPM3.m", "MATLAB", 0, 276, 0, 0, 162, 71, 509
"Total", "-", 1, 2204, 19, 2467, 1046, 651, 6388